11111111111111111111111111111111111111111111111111111111
1P0000000000000000000000000000000000000000C0C00000C000C1
100000000000000000000000000000C00000C00000000C0000000001
1C00000C00000000C0000000000C0000000000000000000000000001
100000000000000100C000000000C000000000000000000000000001
10000000000000000000000000000000000000000000000000000001
10000000000000000000000111111111111111111111111111111111
10000111111111111111111111111111111111111111111111111111
10C00000000C000000C000000C0000000000000000000CCC00000001
10000000000000000000000000000000000000000000000000000001
10000000000000000000000000000000000000000000000000000001
100000000C000000000C000000C00000000C000000000000000C0001
100000000000000000001000000C000C00C00C00C0000000000000E1
11111111111111111111111111111111111111111111111111111111