11111111111111
10000000000000
10C0000C000001
110P00000C0001
1C000000C00001
100000000000E1
11111111111111