1111111
1EC10C1
1P000C1
1111111